xxxxxxxxxxxxxxxxxxxx
x..................x
x.xxxxxxxxxxxxxxxx.x
x.x       b      x.x
x.xxxxxxxxxxxxxxxx.x
x..................x
x.x.x.xx   xx.x.x..x
x...x.x c n x.x.x xx
x...x.x b i x.x.x..x
x.xxxxxxxxxxxxxxx..x
x........p....x....x
xxxxx...xxx...xxxxxx
x.................xx
x.......xxx........x
xxxxxxxxxxxxxxxxxxxx
